1111111111111111111111111111111111111111111111111111111111111111111111111111111111111111111111111111111111
1111111111000000000000000000000000000000001111111111000000000000000000000000001111111111000000000000001111
1111111111000000000000000000000000000000001111111111000000000000000000000000001111111111000000000000001111
1111111111000000000000000000000000000000001111111111000000000000000000000000001111111111000000000000001111
1111111111000000000000000000000000000000001111111111000000000000000000000000001111111111000000000000001111
1111111111000000000000000000000000000000001111111111000000000000000000000000001111111111000000000000001111
1111111111000000000000000000000000000000001111111111000000000000000000000000001111111111000000000000001111
111111111100000000000000000000000000000000111111111100000000000000000C000000001111111111000000000000001111
1111111111000000000000000000000000000000001111111111000000000000000000000000001111111111000000000000001111
1111111111000000000000000000000000000000001111111111000000000000000000000000001111111111000000000000001111
1111111111000000000000000000000000000000001111111111000000000000000000000000001111111111000000000000001111
1111111111000000000000000000001111111111000000001111111111111111111111111111000000000000000000001111111111
1111111111000000000000000000001111111111000000001111111111111111111111111111000000000000000000001111111111
1111111111000000000000000000001111111111000000001111111111111111111111111111000000000000000000001111111111
1111111111000000000000000000001111111111000000001111111111111111111111111111000000000000000000001111111111
1111111111000000000000000000001111111111000000001111111111111111111111111111000000000000000000001111111111
1111111111000000000000000000001111111111000000001111111111111111111111111111000000000000000000001111111111
1111111111000000000000000000001111111111000000001111111111111111111111111111000000000000000000001111111111
1111111111000000000000000000001111111111000000001111111111111111111111111111000000000000000000001111111111
1111111111000000000000000000001111111111000000001111111111111111111111111111000000000000000000001111111111
111111111100000000000000000001111111111000000001111111111111111111111111111000000000000P000000011111111111
1111111111111111111111111111111111111111111111111111111111111111111111111111111111111111111111111111111111
